111111111111111
1P00O101O001OC1
111001010011001
101100000000001
1001010O1C01111
110C0O0C10010E1
111C0111C100011
111111111111111
