111111111111111
1P10O1C1C0010E1
101001010011001
1011000000000O1
1001001O1C01111
1O0C001C00000C1
110C0111C1C00O1
111111111111111
