111111111111111
1P10O101O0010E1
101001010011001
101100000000001
1001001O1C01111
110C001C0001001
111C0111C100011
111111111111111
