1111111111111111111
1P00000101000000001
1000000101000000001
10000000E0000000001
10000C0000100C00001
10000C0000100000001
100000000110C000001
10000C00000C0000001
1000000000000000001
1111111111111111111
