1111111111111111111
1P01C0O101OO00010E1
1001000101000011001
1001110000001000001
1000010010100C01111
11100C001C100001001
11000O000110C000001
10010C01111C0100011
10C1C001C00001C0111
1111111111111111111
