11111111
1P0000C1
111101O1
10000111
1C1000E1
11111111
