11111111
1PO100E1
10C10O01
10100101
10C01OE1
11111111
