11111111
1PO10001
10C10O01
10100101
10C01OE1
11111111
